OOOOOOOOOOOOOOOOOOOOOOOO
OOO     OO O OOO   O O O
OO  OOO       O  OOO O O
OO OO OOOOOOOO O .    OO
O  OO OOO    O O.OOOOO O
OOX  .     O O O OOO O O
O  OO OOOO O O.O   O   O
OO OO OOOO O     OOOO  O
OO.OO.OO OOOOOOOOOOOOO O
OO OO  . OOO      OO   O
OO.OOOOOOO O OOOO   OOOO
OO             OO.OOOOOO
OO      OOO.OOOO  O    O
OO OOO    O OOOOOOO  O U
O     OO OO          OOO
OOOOOOOOOOOOOOOOOOOOOOOO