OOOOOOOOOOOOOOOOOOOOOOOOOOO
OO      C  OOO OO OOOO OOXO
OO OOOOO O OOO OO OOOO OO O
OO    OO O       C    C   O
OOOOOOOO OOOOOOOO OOOOO OOO
O          C    O OO OO OOO
OOOOOOOOOOO OO OOOOO OO OOO
OO    O OOO OO O     OO OOO
OO OOOO OOO OOOO OOOOOO OOO
OO  C       OO O    C  C  O
OOOO OOOOOOOOO OOOOO OO OOO
OO O OO              OO OOO
OO O OOOOOOOOOOOOOOO     OO
OO  C   OO           OOO OO
OOOO OO OO OOOOOOOOOOOOO OO
O OO OO  1 OO OO OOO OOO OO
O OO OO OOOOO OO OOO OOO OO
O OO OO OO OO OO OOO OOO OO
O OO OO OO OO OO OOO OOO OO
O    OO    OO    C        O
O OOOOOOOOOOOOOOO OOOOOOOOO
OC      C      OO O       O
O OO OOO OOOOOOOO O OOOOOOO
O OO OOO O       COC      O
OOOOOOOO O OOO OO O OO O OO
O       C  OOO OO   OO O OO
OOOOOOOOOOOOOOOOOOOOOOOOOOO