OOOOOOOOOOOOOOOOOOOOOOOOOOO
OO            XO C   OOO OO
OO OOOO OOOOOOOOO OO OOO OO
OO    OOOO        OO     OO
OO OOOO OOOOOOOOO OOOOOOOOO
OO O   C          O      OO
OO OOOO OOOOOOOOOOO OOOOOOO
OO   OO           OC     OO
OOOO OO OOOOOOOOOOO OOOOOOO
OO OC  C   C  C   O      OO
OO O OOOOOO OO OOOO OOOOOOO
OO OC    OO OO OO  C     OO
OO O OOO OO OO OOOOOOOOO OO
OOC  OOO OO OO     2     OO
OO OOOOO OO OOOOOOOOOOOOOOO
OO O     OO OOO          OO
OOOOOOOO OOOOOOOOOOOOOOO OO
O    C   O OO           COO
OOOOO OOOO OOOOOOOOOOOOO OO
O    C  C      OO OOO OO OO
OOOOOOOO OO OOOOO OOO OO OO
OO O     OO O      O    COO
OO O OOO OOOO1OOOOOOOOOO OO
OO   OOO    O      C     OO
OO O OOO OOOO OOOOO OOOOOOO
OO O OOO     C    O       O
OOOOOOOOOOOOOOOOOOOOOOOOOOO