OOOOOOOOOOOOOOOOOOOOOOOOOOO
OOX   OO   OO      C      O
OO OOOOO O OOOOOOOO3OOOOOOO
OO OO    O        O   C  OO
OO OO OOOOOOOOOOO OOOO OOOO
OO OO   C   O     O OO OO O
OO OO OO OOOOOOOO O OO OO O
OOC   OO O       C C O    O
OO OOOOOOOOOOO OOOO OO OOOO
OOC   OO    OO O C C  C   O
OO OOOOO OO OOOOO OOOO OOOO
OO   C   OO O     O   C   O
OOOOO OOOOOOOOOOO1OOOOOOOOO
O       OOO      C C      O
OOOOO OOOOO OOOOO O OOOOO O
OO   C  OOO    OO O     O O
OO OOOO2OOOOOOOOO O OOOOOOO
OO OO  C    O     OC  C   O
OO OO OO OOOOOOOO O OO OOOO
OO OO OO O        O OO    O
OO OOOOOOOOOOO OOOOOOOOOO O
OOC C       OO O     OO O O
OO O OOOOOOOOO OOOOO OO O O
OO O     OO   C   OO OO O O
OO OOOOOOOO OO OOOOO OO O O
OO    O       C         O O 
OOOOOOOOOOOOOOOOOOOOOOOOOUO 